새로운 태그들

section : 일반적인 문서나 애플리케이션 영역을 표시합니다. 섹션의 제목을 나타내는 h1~h6와 함께 사용할 수 있습니다.

article :  뉴스 기사나 블로그 글 같은 독립적인 콘텐츠를 표시합니다.

aside : 문서의 주요 부분을 표시하고 남는 사이드 바 콘텐츠를 표시합니다.

hgroup : 제목과 그에 관련된 부제목을 하나로 묶습니다.

header : 헤더 부분으로, 사이트 소개나 내비게이션 등을 표시하기도 하고 내용 중간에서는 머리글 역할을 하기도 합니다.

footer  : 푸터 부분을 표시합니다. 사이트 제작자나 저작권정보 등을 나타낼 때 주로 사용합니다.

nav  : 사이트 안의 내비게이션 요소를 표시합니다.

figure, figcaption  : 그림이나 비디오 같은 멀티미디어 콘텐츠에 캡션을 붙이려고 할 때 사용합니다.

audio , video  : 멀티미디어 콘텐츠를 표시합니다. 애플리케이션 개발자들이 사용자 인터페이스르 직접 만들수 있는 API를 제공합니다.

embed : 플러그인 콘텐츠를 표시합니다.

mark : 텍스트에 형광펜으로 칠한 것과 같은 강조 효과를 만듭니다.

progress : 시간이 걸리는 작업과정을 막대로 표시합니다.

meter : 측정값을 표시합니다.

time : 날짜나 시간을 표시합니다.

ruby, rt , rp : 루비 문자를 표현합니다.

canvas : 웹상에 그래픽을 표시합니다. API와 함께 사용해 다양한 애플리케이션을 만들 수 있습니다.

command : 사용자 실행 명령어를 표시합니다.

details  : 추가적인 정보나 사용자가 요청하는 정표를 표시합니다.

detailst : 사용자가 텍스트 필드에 내용을 입력할 때 선택할 수 있는 값들을 목록으로 보여줍니다.

keygen : 양식(form)을 서버로 전송할 때 한 쌍의 키를 만들어 private key(프라이빗 키)는 로컬에 저장하고 public key(퍼블릭 키)는 서버에 저장합니다.

output : 수학적인 계산의 결과값을 표시합니다

변경된 태그

a : href 속성 없이 사용하면 '널 링크'로 사용됩니다.

addess : 실제 우편물 주소를 표시합니다.

b : 텍스트를 진하게 표시 , 중요하지 않지만 진하게 표시할때 사용

hr : 단락 단위로 주제를 바꾸려고 할 때 사용

i : 텍스를 기울어지게 표시, 주변 컨텐츠에서 따로 표시할때 사용

menu : 실제 문서 메뉴 정보를 제공하는 데 사용합니다

small : 세부 주석이나 법적 인쇄 문서에서 작은 인쇄 정보를 표시할 때 사용합니다

strong : 글자를 진하게 강조 , 중요한 정보를 표할때 사용
 